giveElytra - Altiora : ul,dl,dl,r,r,ul,l,ul,r,r,r,dl,dr
saveToMem - Huginn's Gambit : ul,ur,ul,l,l,dr,dr,r,ul,dl,dl
getTopOfList - Derivation Distillation : ul,l,dr,dl,r,ur
blink - Blink : dl,r,r,ur,ul,l,l,dr,r
convertAllToList - null : ul,l,l,dr,dl,r,r,ur,l,ul,dl,dr,ur,dl,l,l,ur,ul,r,r,dr
rechargeItem - Recharge Item : ul,l,dl,dr,r,ur,ur,l,ul,dl,l,dr,dl,r,dr,ur,r,ul
myPosEye - null : ur,ul,dl,dr,r,ul,dl
placeBlock - Place Block : dl,l,ul,ur,r,dr,l,ul
addToList - Integration Distillation : dl,l,ur,ul,r,dr
createArtifact - Craft Artifact : r,r,r,ul,l,dl,dr,r,ur,r,ul,ul,l,l,dl,dl,dr,dr,r,r,ur,ur,ur,ul,l,ul,dl,ul,dl,l,dl,dr,dl,dr,r,dr,ur,dr,ur,r,ur,ul
weakness - White Sun's Nadir : ul,l,dl,dr,r,ur,l,dl,dl,r,r,ul,ul
eyePos - Compass' Purification : r,ul,dl
explode - Explosion : r,ul,dl,dl,r,ul,ul,dl,r
getNthElement - Selection Distillation : ul,r,dr,dl,l,ur
canLoad - Auditor's Reflection : r,ul,l,dl,dr,r,ur,r
me - Mind's Reflection : ur,ul,dl,dr
getNumber6 - Numerical Reflection 6 : dr,ur,ul,dl,r,dr,l,l
getStackSize - Flock's Reflection : ul,l,l,dr,dl,r,r,ur,l,ul,dl,dr,ur
breakBlock - Break Block : r,ur,l,dl,dr,r,ur,ul
multiply - Multiplicative Dstl : dr,dr,ur,ul,dl,dl
getNumber1 - Numerical Reflection 1 : dr,ur,ul,dl,r,r
direction - Alidade's Purification : ur,ur,l
getListLength - Length Purification : ur,ur,ul,dl,dr,dr
meFlight - null : ur,ul,dl,dr,ul,dl,dl,r,r,ul,l,ul,r,r,r,dl,dr
levitate - Blue Sun's Nadir : l,dl,dr,r,ur,ul,dl,dl,dl,r,r,ul,ul,r
copyFromMem - Muninn's Reflection : ur,ul,ur,r,r,dl,dl,l,ur,dr,dr
canSave - Assessor's Reflection : r,dl,l,ul,ur,r,dr,r
duplicate - Gemini Decomposition : r,ul,dl,ul,dl,r
execute - Hermes' Gambit : dr,l,ul,dl,dr,r
addNElements - Flock's Gambit : dl,l,l,ur,ul,r,r,dr
push - Impulse : dl,r,r,ur,ul,l,l,dr,r,r
pushEmptyList - Vacant Reflection : ur,ul,l,dr,dl,r,ul,ur
myPos - null : ur,ul,dl,dr,ur,dr,l
removeWater - Destroy Liquid : dl,ul,ur,dr,dr,dl,ul,dl,ul,ur
normalPos - Compass' Purification II : ur,dr,l
getNumber10 - Numerical Reflection 10 : dr,ur,ul,dl,r,dr
blockImLookingAt - null : ur,ul,dl,dr,r,ul,dl,ur,ul,dl,dr,ur,ur,l,r,r,ur,l,dr,dr,l,ur
archer - Archer's Distillation : r,r,ur,l,dr,dr,l,ur
placeWater - Create Water : dr,ur,ul,dl,dl,dr,ur,dr,ur,ul
wither - Black Sun's Nadir : dl,dr,r,ur,ul,l,dr,dl,dl,r,r,ul,ul,ur
